11111111111111111111111111111
1000P000000000C000000C00000E1
11111111111111111111111111111